10 10
7 0 0 0 0 0 0 0 0 0
0 0 1 0 0 0 0 1 0 0
0 0 0 0 1 0 0 0 0 0
0 0 0 0 3 0 0 4 1 0
0 0 5 0 0 0 0 2 0 0
0 1 1 0 0 0 2 0 1 0
0 0 0 9 8 7 6 0 1 0
0 1 0 0 0 0 0 0 0 0
0 4 1 0 1 1 0 1 1 0
9 0 0 0 0 0 0 0 0 8