10 10
0 0 0 0 0 0 0 0 0 0 
0 0 0 0 0 4 4 0 0 0 
0 0 3 0 0 0 0 0 0 0 
3 0 0 0 0 0 0 0 0 0 
3 0 0 0 0 0 0 0 5 0 
3 0 0 0 0 0 0 0 5 0 
0 0 0 0 0 7 7 7 0 0 
0 0 0 0 0 7 6 7 0 0 
0 0 0 0 0 7 7 7 0 0 
0 0 0 2 2 2 0 0 0 0 